10;
0;0;0;0;0;0;0;0;0;0;
0;2;2;2;2;2;2;2;3;0;
0;2;0;0;2;2;2;0;2;0;
0;3;4;4;0;0;2;2;2;0;
0;2;0;0;2;2;2;2;2;0;
0;2;2;2;1;2;0;0;2;0;
0;2;2;2;0;0;4;4;3;0;
0;2;0;2;2;2;0;0;2;0;
0;3;2;2;2;2;2;2;2;0;
0;0;0;0;0;0;0;0;0;0;