10;
0;0;0;0;0;0;0;0;0;0;
0;2;2;2;5;2;2;2;2;0;
0;3;0;0;0;2;0;0;3;0;
0;2;2;0;0;2;0;2;2;0;
0;0;2;0;6;6;0;2;0;0;
0;2;2;0;6;6;0;2;2;0;
0;2;0;0;0;0;0;0;2;0;
0;3;0;2;2;1;2;0;3;0;
0;2;2;2;0;0;2;2;2;0;
0;0;0;0;0;0;0;0;0;0;


