10;
0;0;0;0;0;0;0;0;0;0;
0;6;2;2;2;3;2;2;4;0;
0;2;0;0;2;0;0;2;0;0;
0;2;0;2;2;2;2;2;2;0;
0;2;2;2;0;2;0;0;3;0;
0;2;0;2;2;1;2;2;2;0;
0;3;0;0;2;0;2;0;2;0;
0;2;0;2;2;2;2;0;2;0;
0;4;2;2;0;0;3;0;6;0;
0;0;0;0;0;0;0;0;0;0;