10;
0;0;0;0;0;0;0;0;0;0;
0;2;2;2;2;2;2;3;0;0;
0;2;0;2;0;2;0;2;4;0;
0;2;2;2;2;2;3;2;0;0;
0;2;0;2;0;2;0;2;4;0;
0;1;2;2;2;2;2;3;0;0;
0;2;0;2;0;2;0;2;4;0;
0;2;2;2;2;2;2;2;0;0;
0;2;0;2;0;2;0;3;6;0;
0;0;0;0;0;0;0;0;0;0;